Acide	Appliquer un Huile de Chasse ou une Décoction augmente les dégâts de l'arme du personnage de 1.
Affinité	Le personnage peut utiliser la compétence 'Affinité' de son Patron.
Affront	1 PE: Le personnage crie sa gloire et entre dans un posture de combat robuste pendant 2 minutes. Pendant la durée d'Affront, le personnage gagne 4 PV temporaires. Ceci est une posture de combat.
Analyse	Une fois par jour, le personnage gagne un nombre de PE temporaires égal a son maximum de PE qui peuvent uniquement être utilisés pour des compétences de Leadership.
Anticipation	Une fois par Duel, le personnage peut ignorer l'effet d'une attaque physique qui impose un effet, mais en subit quand même les dégâts.
Anticipation	Le personnage est presque toujours a l'affût et le prendre par surprise est extrêmement difficile. Une fois par événement, le personnage peut ignorer les dégâts et les effets d'une attaque. De plus, le personnage réduit les dégâts Critiques qu'il subit de 2 en tout temps.
Appels int.	Le personnage apprends trois Appels intermédiaires. Le personnage possède 10 points de Magie.
Appels maj.	Le personnage apprends trois Appels majeurs. Le personnage possède 15 points de Magie. Le personnage peut seulement acquérir cette compétence s'il ne possède pas d'autre compétence de Sorts majeurs.
Appels mineurs	Le personnage apprends trois Appels mineurs. Le personnage possède 5 points de Magie.
Arcanisme	Le personnage sait reconnaître l'influence de la magie Arcane sur le monde qui l'entoure. Le personage peut identifier si un objet ou une créature est sous l'influence de magie Arcane. De plus, le personnage possède des connaissances générales sur les grands mages et institutions des Terres Connues.
Archerie	Le personnage peut utiliser Coup puissant avec des armes de lancer et à distance.
Archévangélisme	Évangélisme accorde désormais 5 points de Vie temporaires.
Ardeur	Affront donne 4 points de Vie temporaires de plus.
Aristocratie	Permet au personnage d'identifier la noblesse, les dirigeants ainsi que les enjeux majeurs d'un lieu de son choix.
Armurier	Le personnage sait réparer les armures en tout genre selon les règles de l'art. Le personnage peut, avec 5 minutes de travail, réparer une armure brisée.
Arrestation	Le personnage peut infliger des dégâts Contondants avec toutes les armes qu'il sait manier, peu importe de quelle arme il s'agit.
Arrogance	1 PE: Le personnage entre dans une posture de combat téméraire. Durant sa posture, le personnage augmente les dégâts de ses armes de 1, mais augmente également les dégâts qu'il subit de 2. Ceci est une posture de combat.
Aspect animal	1 PE: Le personnage canalise l'esprit d'une bête et transforme son bras pour porter une attaque brutale. Le personnage inflige 3 dégâts au toucher à une cible.
Aspect du climat	Aspect animal inflige un effet selon son élément. Contondant: Renverse Feu: +1 dégâts Froid: Lenteur 30 secondes Foudre: Projection 5 mètres
Aspect primordial	Le personnage peut infliger des dégâts Contondant, de Feu, de Froid, ou de Foudre avec Aspect animal.
Assaut	1 PE: Le personnage effectue une frappe puissante et précise qui inflige +2 dégâts. Assaut doit être effectué avec une arme à deux mains. Ceci est une compétence de combat.
Assurance	Les points de Vie temporaires accordés par Duel persistent pour 10 minutes après la fin du Duel.
Athlétisme	Le personnage est immunisé aux effets de Lenteur et les effets d'Immobilisation deviennent des effets de Lenteur.
Attaque vicieuse	Le personnage inflige 1 dégât supplémentaire à sa Proie avec Coup puissant.
Autopsie	En examinant le corps d'une créature pendant 30 secondes, le personnage peut déterminer la cause (Magie, poison ou blessures) et le moment de la mort de la cible. 
Aveuglement	1 PE: Le personnage lance un catalyseur aveugle la cible et lui inflige un effet d'Aveuglement (10 secondes).
Bain de sang	Le personnage peut achever une créature pour regagner 3 points de vie ou 1 point de Magie.
Bandages	Le personnage peut avoir une trousse de plus, pour un total de 3. De plus, le personnage peut dépenser 2 PE lors de l'application d'une trousse pour soigner la cible de 6 PV supplémentaires.
Bandoulière	Le personnage possède maintenant une Bombe de plus et Bombe inflige 1 Dégâts de plus.
Bannissement	Une fois par jour, le personnage peut tenter d'exiler un être extérieur du  monde des mortels.  Il peut le faire avec un marché, un rituel ou carrément par la force. Si la cible est sous l'emprise de Capture, les chances de succès sont plus grandes.
Bastion	2 PE: Le personnage renforcit son corps contre les assauts et gagne 4 PV temporaires. Ceci est un effet Corporel.
Berceuse	1 PE: Le personnage peut jouer ou chanter afin de calmer une créature et l'amener dans un état de calme et de détente. L'effet prends fin si la cible est en combat ou est attaquée. Cet effet dure aussi longtemps que le personnage continue de jouer ou de chanter.
Berserk	Rage augmente les dégâts de 1.
Bestiaire	Permet au personnage de relever les caractéristiques d'une créature inconsciente en l'étudiant pendant 2 minutes. Le personnage doit faire affaire avec l'Équipe Scénaristique afin de savoir ce qu'il découvre.
Bibliothèque	Le personnage gagne deux usages de Thésaurus. Le personage peut désormais identifier la majorité des objets qu'il était incapable d'identifier avec Thésaurus.
Bionomie	Permet au personnage d'apprendre des informations sur la faune et la flore d'un lieu de son choix, ou sur une entité de nature forestière. Le personnage doit faire affaire avec l'Équipe Scénaristique afin de savoir ce qu'il découvre.
Bolas	1 PE: Le personnage lance un catalyseur qui emmêle les jambes de la cible et lui inflige un effet de Lenteur (30 secondes).
Bombardier	Le personnage possède maintenant une Bombe de plus et celles-ci peuvent infliger des dégâts physiques, de feu ou magiques.
Bombe	Le personnage dispose d'une Bombe, qu'il peut lancer comme un catalyseur, qui infligera 3 dégâts de feu.  Après l'avoir utilisé, le personnage doit bidouiller au moins 10 minutes pour pouvoir la lancer de nouveau.
Bombe flash	Le personnage peut transformer un usage de Bombe pour aveugler sa cible pendant 10 secondes au lieu d'infliger des dommages.
Brise-fer	2 PE: Le personnage frappe l'arme ou le bouclier de la cible et le brise. L'arme ou le bouclier devra être réparé pour être utilisé à nouveau. Ceci est une compétence de combat.
Canalisation	Le personnage sait canaliser la magie Arcane à travers son corps. Le personnage peut utiliser une arme de mêlée pour ses sorts de toucher. L'arme n'inflige aucun dégâts et ne peut bénéficier de Coup puissant.
Capture	Si le personnage parvient à serrer la main d'un être extérieur, ce dernier est immobilisé et ne peut tenter aucune offense tant que la cible elle-même ne subit pas d'offense. L'extérieur capturé aura de la difficulté à mentir et devra dire d'où il vient si on lui demande.
Carquois	Le personnage peut fabriquer 3 projectiles en 5 minutes qui infligent 1 dégât supplémentaire. Le personnage peut seulement fabriquer et posséder 3 projectiles à la fois.
Cauchemar	3 PE: Le personnage provoque les âmes errantes autour de lui et les somme d'effrayer les créatures dans la zone. Le personnage inflige un effet de Peur (1 minute) à toutes les créatures sauf une dans une zone de 10 mètres de rayon centrée sur lui.
Célérité	Instinct accorde désormais 4 points de vie temporaires sous les même conditions.
Cérémonie	Le personnage peut conduire les rituels sacrés reliés à sa Foi.
Chaînes du Sous-monde	Poigne du sous-monde inflige un effet d'Immobilisation (10 secondes) à la cible.
Chants int.	Le personnage apprends trois Chants intermédiaires. Le personnage possède 10 points de Magie.
Chants maj.	Le personnage apprends trois Chants majeurs. Le personnage possède 5 points de Magie. Le personnage peut seulement acquérir cette compétence s'il ne possède pas d'autre compétence de Sorts majeurs.
Chants min.	Le personnage apprends trois Chants mineurs. Le personnage possède 5 points de Magie.
Charge	1 PE: Le personnage charge sur 5 mètres et effectue une frappe qui inflige +2. Ceci est une compétence de combat.
Châtiment	1 PE: Le personnage canalise sa foi dans une frappe consacrée. Le personnage effectue une frappe qui inflige +1 Béni. Ceci est une compétence de combat.
Chausse-trappe	1 PE: Le personnage peut fabriquer et poser un piège qui infligera un des effets suivants, au choix lorsqu'il pose le piège: - Projection (5 mètres) - Immobilisation (10 secondes) - Renverse Le personnage peut déployer une seule Chausse-trappe à la fois.
Chemin de croix	Une vie de mutilation noie la douleur du personnage, ce qui lui permet de subir une troisième blessure sans mourir.
Chirurgie	Une fois par événement, le personnage peut prodiguer des soins a une cible pendant 10 minute afin de la soigner d'une blessure mineure ou la ramener de l'agonie à l'inconscience si l'agonie est arrivée dans les 10 dernières minutes.
Cicatrices	Le personnage gagne 3 points de Vie temporaires tant qu'il arbore des cicatrices au visage, sur le corps et sur les bras, et qu'il ne porte aucune armure. Ces points de Vie temporaires se régénèrent après 10 minutes passé hors combat.
Code du voleur	Le personnage est immunisé aux effets d'Aveuglement et les effets d'immobilisation deviennent des effets de Lenteur.
Commandement	Motivation donne 4 points de Vie temporaires.
Communion	Une fois par jour, suite à une courte prière a son Patron, le personnage gagne un nombre de PE temporaires égal a son maximum de PE qui peuvent uniquement être utilisés pour des compétences de Conjuration.
Condamnation	3 PE: Le personnage désigne une cible à portée Directe qui devient immunisée aux Soins pendant 5 minutes. Cet effet est une Malédiction.
Conduit	2 PE: Le personnage peut étendre un sort qui le cible lui uniquement pour affecter son Partenaire également. Le personnage doit être à portée de toucher de son Partenaire.
Confiance	1 PE: le personnage peut poser la main sur un allié et lui inspirer confiance. L'allié ciblé est immunisé aux effets de Peur et de Lenteur, et les effets d'Immobilisation agirons comme des effets de Lenteur. Confiance dure jusqu'à la fin du prochain combat.
Connaître l'ennemi	Le personnage réduit les dégâts qu'il subit de 1 contre les attaques infligées par sa Proie.
contre-attaque	Utiliser Esquive augmente les dégâts de la prochaine frappe physique de 1. Cet effet ne se cumule pas avec lui-même.
Contre-sort	1 PE: Le personnage frappe un ennemi en train de lancer un sort et lui inflige un effet de Contre-sort. Ceci est une compétence de combat.
Conviction	Le personnage récupère 2 PV chaque fois qu'il lance une prière.
Cosmologie	Permet au personnage d'apprendre des informations sur les créatures ou concepts qui se cachent par-delà le monde des mortels. Le personnage doit faire affaire avec l'Équipe Scénaristique afin de savoir ce qu'il découvre.
Coup bas	1 PE: Le personnage se positionne pour effectuer une frappe vicieuse qui cible les points faibles de la cible. La prochaine frappe inflige des dégâts critiques.  (Le personnage doit mentionner Coup bas lorsqu'il porte la frappe. Par exemple, s'il utilise Coup bas avec Coup puissant, il dira "Coup bas, Puissant, 3 Critique." Coup bas s'applique en priorité aux compétences de Coup puissant, donc un Fléau avec Coup bas inflige uniquement des dégâts critiques, et non pas critiques+maudits, par exemple.)
Coup critique	2 PE: Le personnage effectue une frappe précise qui inflige +1 Critique. Ceci est une compétence de combat.
Coup de grâce	2 PE: Le personnage effectue une frappe précise et fatale contre la cible de Duel. Coup de grâce inflige +3 dégâts et met fin à Duel. Ceci est une compétence de combat.
Covenant	Le personnage peut utiliser la compétence 'Covenant' de son Patron.
Cri de guerre	Le personnage peut infliger un effet de Peur (30 secondes) à une créature qui l'entends hurler lorsqu'il entre en Rage.
Croyance	Le personnage sait reconnaître l'influence de la magie Divine sur le monde qui l'entoure. Le personage peut identifier si un objet ou une créature est sous l'influence de magie Divine. De plus, le personnage possède une connaissance de base sur les grandes religions des Terres Connues.
Cruauté	La cible de Malice est immunisée aux Soins pendant 1 minute. Cet effet est une Malédiction.
Culture	Permet au personnage d'apprendre les coutumes et façons de vivre d'un lieu de son choix, ainsi que les rumeurs qui y courent.
Cure	Une fois par jour, le personnage peut performer un examen sur la cible et la libérer de tous les effets de poisons qui l'affligent.
Danger	Piège inflige 4 dégâts. Le personnage peut déployer un Piège de plus.
Déchaînement	Le personnage est immunisé aux effets de Lenteur, de Charme et de Peur pendant la durée de Rage. Utiliser Rage dissipe également ces effets.
Décoctions	2 PE: Le personnage peut appliquer une huile sur son arme ou sur ses munitions. L'arme du personnage inflige des dégâts Bénis, Maudits ou Magiques pour la prochaine minute. Ceci est un effet Martial.
Défenseur	Gardien accorde désormais 4 points de Vie temporaires.
Défi	Le personnage peut infliger un effet de Provocation avec ses Coups puissants pendant la durée d'Affront. (En plus d'infliger les dégâts de Coup puissant.)
Démanteler l'armure	Le personnage exploite les faiblesses dans l'armure de sa cible avant de l'égorger. La cible d'Égorgement perd 10 Points d'Armure avant de subir les dégâts.
Désarmement	1 PE: Le personnage frappe l'arme ou le bouclier de la cible et lui inflige un effet de désarmement. Ceci est une compétence de combat.
détention	Une fois par jour, le personnage peut désigner une cible inconsciente et la prendre en détention. Ceci la ramène consciente à 1 PV et tant que le personnage maintient sa prise sur lui (contact physique, corde,  menottes, etc. selon le confort de la cible). La cible ne peut pas s'enfuir d'aucune manière tant que le lien n'est pas interrompu par le personnage.
Détermination	Les combats et les épreuves ont endurci le physique et l'énergie du personnage. Le maximum de Points d'Énergie du personnage est augmenté de 1.
Deux pour un	Le personnage possède maintenant une Bombe de plus et peut préparer deux catalyseurs en même temps. (Le personnage bidouille 10 minutes pour produire deux bombes, ou 5 minutes pour en produire deux s'il possède Poudre noire)
Dialecte	Le personnage apprend une Langue supplémentaire de son choix.
Discours de guerre	Une fois par jour, le personnage peut effectuer un discours de guerre pour promettre la victoire à ses alliés.  Jusqu'à 6 alliés qui écoutent le personnage donner le discours gagnent 1 point de Vie temporaire pour chaque allié affecté, et le personnage gagne 1 point de Vie temporaire pour chaque allié qu'il affecte. Le discours doit durer environ une minute. Les effets de Discours de guerre durent jusqu'à la fin du combat. Ceci est un effet Corporel.
Dissipation	3 PE: Le personnage dissipe une malédiction ou une bénédiction qui l'afflige.
Divination	Une fois par événement, le personnage peut consulter les esprits et obtenir une réponse à une question qu'il leur pose. La réponse peut être cryptique. Le personnage doit contacter l'Organisation pour recevoir la Divination.
Drain	Toucher une cible avec Flèche d'os redonne 1 PE au personnage.
Duel	1 PE: Le personnage entre dans une posture de combat solenelle et concentrée et déclare une cible comme son adversaire. Pendant la durée de Duel, le personnage gagne 4 Points de Vie temporaires. Duel prend fin si le personnage attaque une autre cible que celle de Duel et ne pourra pas réutiliser Duel pour le reste du combat.  Ceci est une posture de combat.
Dur à cuire	Vaincre un adversaire durant l'Affront permet au personnage de crier sa victoire. Ceci redonne la moitié des Points de Vie temporaires d'Affront et en étend la durée de deux minutes.
Dynamite	Une Bombe convertie en Mine inflige maintenant 5 dégâts.
Éclair	Uthma Durga Suhgan Aduantas Uthmarash Le personnage lance un catalyseur qui inflige 2 dégâts de Foudre.
Éclat	1 PE: Le personnage canalise l'arcane dans une frappe étincelante. Le personnage effectue une frappe qui inflige +1 Magique. Ceci est une compétence de combat.
Égide	3 PE: Le personnage peut bloquer un sort de dégâts avec son bouclier. Le personnage peut également protéger un allié au toucher avec Égide ou se couvrir lui et un allié au toucher d'un sort de zone.
Égorgement	Une fois par jour, Le personnage peut profiter d'un moment d'inattention afin de poignarder une cible dans le dos avec une dague ou un couteau, infligeant 7 dégâts supplémentaires. Le personnage ainsi que sa cible doivent être hors-combat. Le personnage peut utiliser une matraque au lieu d'une dague pour infliger des dégâts contondants avec Égorgement. Cette compétence ignore la limite de dégâts physiques.
Éloquence	Le personnage apprend une Langue supplémentaire de son choix.
Embuscade	Une fois par jour, le personnage peut infliger 4 dégâts physiques à un cible à portée directe (Maximum 10 m.). Le personnage et la cible doivent être hors-combat et le personnage doit être caché de la cible.
Engourdissement	Le personnage ne subit désormais que des blessures légères.
Enquête	Utiliser l'option "Enquêter (Crime)" comme action de Temps libre ne fait pas courir le risque d'être découvert au personnage.
Entente	salut papa jpeux tu parler a mononcle
Entraînement	Deux fois par jour, le personnage peut entraîner un allié au combat. Au bout de 5 minutes de pratique, l'allié et le personnage gagnent 1 PE temporaire. Cet effet ne se cumule pas avec lui-même.
Entrevue	Une fois par jour, le personnage peut s'entretenir avec une autre créature et lui imposer un effet de Charme pour la durée de la conversation.
Escrimeur	Pendant un Duel, le personnage inflige 1 dégâts supplémentaire s'il manie une arme à une main.
Esquive	1 PE: le personnage peut ignorer une attaque physique en mimant qu'il évite le coup et en criant ''Esquive''.  Cette compétence ne fonctionne pas si le personnage porte de l'armure lourde ou est immobilisé.
Étau de la foi	1 PE: Le personnage inflige un effet d'Immobilisation (30 secondes) à une créature à portée directe.
Étranglement	Bolas inflige un effet de Silence (10 secondes) au coût de 1 PE supplémentaire.
Étude	Entre les événements, le personnage peut étudier un sujet de son choix. Le personnage doit faire affaire avec l'Équipe Scénaristique afin de savoir ce qu'il découvre.
Évangélisme	1 PE: Le personnage réduit les dégâts d'un sort qu'il subit de 5.
Évasion	Le personnage réduit les dégâts des attaques à distance (Armes de lancer, flèches, carreaux, sorts à cible unique, effets à catalyseur ou directs) qu'il reçoit de 1. (Minimum de 1)
Éviscération	Le personnage gagne un usage quotidien d'Égorgement, pour un total de 2. Égorgement inflige désormais 13 dégâts supplémentaires. Cette compétence ignore la limite de dégâts physiques.
Examen	Le personnage peut examiner une cible pendant 1 minute afin de détecter si celle-ci est a été victime  d'un poison, d'une potion ou d'un effet physique dans la dernière heure.
Exécution	5 PE: Le personnage effectue une frappe mortelle qui inflige +4 dégâts Critiques.
Exemple	Une fois par jour, s'il accompagne la cible de Motivation au combat, le personnage gagne lui-même 3 points de vie temporaire pour la durée du combat.
Exorcisme	Le personnage inflige des dégâts magiques avec son arme quand il affronte des esprits.  De plus, les Rites offensifs du personnage qui affectent uniquement les morts-vivants affectent désormais les esprits et les démons également. Le personnage peut voir les esprits invisibles.
Expiation	2 PE: Le personnage peut toucher une créature et dissiper les effets Physiques, Martiaux et Spirituels qui l'affectent.
Explosifs	Grenade inflige 1 dégât supplémentaire.
Fauche-vie	2 PE: Le personnage effectue une frappe qui inflige des dégâts Maudits et le personnage récupère des points de Vie égal aux dégâts infligés en frappant la cible. Ceci est une compétence de combat.
Fauche-vie	2 PE: Le personnage effectue une frappe qui inflige des dégâts Maudits et le personnage récupère des points de Vie égal aux dégâts infligés en frappant la cible. Ceci est une compétence de combat.
Faveur	Le personnage peut utiliser la compétence de 'Faveur' de son Patron.
Fendoir	2 PE: Le personnage fend l'air avec son arme et inflige 3 dégâts Physiques dans un cône de 3 mètres devant lui. Fendoir doit être effectué avec une arme à deux mains. Ceci est une compétence de combat.
Festin	Une fois par jour, lorsqu'il est en nature ou en donjon, le personnage peut servir de la nourriture à ses alliés. Manger ce repas guérira 8 PV à tous les alliés qui se seront nourris ainsi.  Le personnage doit apporter assez de nourriture pour chaque personne participant au repas, et les participants doivent y prendre part pour une durée minimale de 5 minutes.
Fil à ressort	Les Chausse-trappes du personnage deviennent plus efficaces et gagnent un effet parmi la liste suivante: - Aveuglement (10 secondes) - Lenteur (1 minute) - Immobilisation (10 secondes)
Flamme céleste	2 PE: Permet au personnage d'immoler ses ennemis. Le personnage fend l'air avec son arme et inflige 3 dégâts de feu dans un cône de 3 mètres devant lui. Ceci est une compétence de combat.
Fléau	1 PE: Le personnage canalise sa magie noire et effectue une frappe qui inflige +1 Maudit. Ceci est une compétence de combat.
Flèche d'os	Yrvin Voskor Vilineris Sphvys, Asariel Zys Le personnage peut lancer un catalyseur qui inflige 2 dégâts physiques.
Flexibilité	Instinct accorde désormais 6 points de vie temporaires sous les même conditions.
Forteresse	1 PE: Le personnage entre dans une posture de combat immuable. Durant sa posture, le personnage est ralenti mais est immunisé aux effets d'Immobilisation et réduit les dégâts physiques qu'il subit de 1.
Fortissimo	2 PE: Le prochain chant du personnage sera lancé avec son effet de Crescendo au maximum.
Fourberie	2 PE:  Le personnage peut fouiller les contenus d'un bourse ou d'une poche portée par quelqu'un sans que la victime s'en rende compte. Le personnage peut placer ou retirer un objet de la bourse ou de la poche. S'il vole des pièces, il peut en voler 5.
Frénésie	Rage dure indéfiniment. (Le personnage doit quand même attaquer des créatures pour conserver l'effet.)
Froid de la tombe	Main glaciale inflige un effet de Paralysie de 5 secondes. Utiliser Main glaciale sur une cible déjà paralysée n'inflige pas l'effet.
Gaillardise	La vie sur la route, les combats salauds et les contrats variés ont endurcis le personnage. Une fois par événement, le personnage peut changer son Inconscience en Léthargie. (Cette compétence peut être utilisée en étant inconscient.)
Gaillardise	La vie sur la route, les combats salauds et les contrats variés ont endurcis le personnage. Une fois par événement, le personnage peut changer son Inconscience en Léthargie. (Cette compétence peut être utilisée en étant inconscient.)
Garde du corps	Utiliser Interception accorde 2 PV temporaires au Partenaire du personnage.
Gardien	Le personnage sait utiliser un pavois et tant qu'il porte un bouclier au bras, il gagne 2 point de vie temporaires. Ces points de vie temporaires se régénèrent après 10 minutes passées hors combat.
Givre	1 PE: Le personnage canalise les âmes errantes et transies dans une frappe frigorifiante. Ceci est une compétence de combat.
Gloire	Vaincre un adversaire durant Affront redonne 3 points de vie au personnage.
Grâce féline	Le personnage peut utiliser son Esquive pour ignorer l'effet de zone d'un sort. Il doit quand même faire un roulé-boulé pour sortir de la zone.
Grenade	1 PE: Le personnage lance une petite bombe qui inflige 1 dégât de feu à une cible.
Hémorragie	1 PE: Le personnage peut infliger des dégâts Critiques sur ca prochaine frappe. Ceci est une compétence de combat.
Herculéen	Le personnage est immunisé aux maladies.
Hérésie	Le personnage sait reconnaître l'influence de la magie Occulte sur le monde qui l'entoure. Le personage peut identifier si un objet ou une créature est sous l'influence de magie Occulte. Le personnage gagne 2 points de vie temporaires. Ces points de vie temporaires se régénèrent après 10 minutes passées hors combat.  
Hiver sans fin	Le personnage peut toucher une cible de plus avec Main glaciale. La deuxième cible doit être différente de la première.
Homme à tout faire	Le personnage acquérit une compétence Tier 2 d'un autre arbre de compétence. Le personnage ne peut pas choisir un compétence d'un arbre qu'il possède déjà et ne peut pas choisir une compétence de magie.
Huiles de chasse	1 PE: Le personnage peut appliquer une huile sur son arme ou sur ses munitions. L'arme du personnage inflige des dégâts de Feu, de Froid ou de Foudre pour la prochaine minute. Ceci est un effet Martial.
Hurlement	Le personnage peut infliger un effet de Provocation à autant de créatures qui peuvent l'entendre hurler lorsqu'il entre en Rage.
Hymne	1 PE: Le personnage joue ou chante et procure un bonus de 1 à l'attaque à une cible de son choix. Ceci est un effet Martial. Aussitôt que le Barde cesse de chanter ou que la cible cesse d'entendre le Barde, les effets prennent fin.
Ignorance	1 PE: le personnage peut ignorer l'effet d'une attaque physique qui impose un effet, mais en subit quand même les dégâts.
Ignorance	2 PE: le personnage peut ignorer l'effet d'une attaque physique qui impose un effet, mais en subit quand même les dégâts.  Ignorance ne se cumule pas avec Obstination.
Immobilisation	1 PE: Le personnage frappe les jambes de la cible et lui inflige un effet d'Immobilisation (30 secondes). Immobilisation n'inflige pas de dégâts. Ceci est une compétence de combat.
Immunité	Le personnage peut ignorer les effets de Poison avec Sang épais.
Infirmier	Transporter une personne inconsciente ne ralenti plus le personnage.  Le personnage peut également transporter deux personne inconsciente, en étant ralenti, cependant.
Initiative	La première attaque du combat effectuée par le personnage inflige +2 dégâts si le personnage l'effectue avec une dague.
Insensible	Le personnage ressent moins la douleur comparativement aux autres. Le personnage est immunisé aux effets de torture et peut jouer sa douleur moins intensément. (Il est tout de même obligatoire de la jouer et de montrer qu'un coup ou un sort l'a affecté.)
Instinct	Le personnage gagne 2 points de vie temporaires tant qu'il porte de l'armure légère ou aucune armure. Ces points de vie temporaires se régénèrent après 10 minutes passées hors combat.
Insulte fatale	Le personnage peut pointer son arme vers un adversaire qu'il voit et utiliser Provocation sans frapper sa cible.
Interception	Le personnage peut intercepter une attaque qui toucherais son Partenaire et la subir à sa place. Le personnage doit être à portée de toucher de son Partenaire.
Invective	Le personnage peut cibler une créature de plus lorsqu'il utilise Provocation ou Insulte fatale.
Investigation	En étudiant un lieu pendant 1 minute ou un objet pendant 10 secondes, le personnage peut déterminer si celui-ci est piégé ou sous l'influence de magie. De plus, le personnage peut considérer jusqu'à 3 de ses points d'Influence comme des points d'Esprit pour réussir une épreuve ou résister à un effet.
Invincible	Le personnage peut ramper durant la durée de son inconscience. Il ne peut toujours pas utiliser de compétences, et n'aura aucun souvenir de la période d'inconscience et ne peut que parler faiblement.
Invocations int.	L'Arcaniste apprends trois Invocations intermédiaires. Le personnage possède 12 points de Magie
Invocations int.	Le personnage apprends quatre Invocations intermédiaires. Le personnage possède 10 points de Magie.
Invocations maj.	Le personnage apprends quatre Invocations majeures. Le personnage possède 15 points de Magie. Le personnage peut seulement acquérir cette compétence s'il ne possède pas d'autre compétence de Sorts majeurs.
Invocations min.	Le personnage apprends trois Invocations mineures. Le personnage possède 6 points de Magie.
Invocations min.	Le personnage apprends quatres Invocations mineures. Le personnage possède 5 points de Magie.
Irréductible	Pendant la durée d'Affront, le personnage est immunisé aux effets de Charme,  de Suggestion, de Domination et de Lenteur, et les effets d'Immobilisation deviennent des effets de Lenteur. Utiliser Affront dissipe les effets contre lesquels il immunise.
Joug glacial	Lame d'hiver inflige un effet de Lenteur (1 minute) aux créatures affectées.
Lame Arcane	2 PE: Le personnage fend l'air avec son arme et inflige 3 dégâts Magiques dans un cône de 3 mètres devant lui. Ceci est une compétence de combat.
Lame d'hiver	2 PE: Le personnage fend l'air avec son arme et inflige 3 dégâts de Froid dans un cône de 3 mètres devant lui. Ceci est une compétence de combat.
Légendes	Permet au personnage d'apprendre les mythes entourant un sujet de son choix.
Lenteur	1 PE: Le personnage frappe les jambes de la cible et lui inflige un effet de Lenteur (30 secondes) en plus des dégâts de son arme.
Lieutenant	Motivation et Ordre de combat affectent deux cibles de plus.
Magelame	Le personnage peut utiliser son arme pour les sorts à Catalyseur. Les sorts du personnage infligent 2 dégâts supplémentaires s'il sont effectués avec l'arme du personnage. (Les sorts de zone sont centrés sur la cible et affectent le personnage également.)
Main de fer	1 PE: Le personnage peut ignorer un effet de Désarmement.
Main de fer	1 PE: Le personnage peut ignorer un effet de Désarmement.
Main glaciale	Rite qui permet au Nécromancien de toucher une créature et lui infliger 2 dégâts de Froid.
Maléfices int.	Le personnage apprends trois Maléfices intermédiaires. Le personnage possède 10 points de Magie.
Maléfices int.	Le personnage apprends trois Maléfices intermédiaires. Le personnage possède 10 points de Magie.
Maléfices maj.	Le personnage apprends trois Maléfices majeurs. Le personnage possède 10 points de Magie. Le personnage peut seulement acquérir cette compétence s'il ne possède pas d'autre compétence de Sorts majeurs.
Maléfices min.	Le personnage apprends trois Maléfices mineurs. Le personnage possède 5 points de Magie.
Maléfices min.	Le personnage apprends trois Maléfices mineurs. Le personnage possède 5 points de Magie.
Malice	Effael Ora, Sobne Seveth, Osnen Zys 2 PE: Le personnage conjoure la magie noire dans son toucher. Malice inflige 2 Maudits à une cible au toucher.
Malveillance	Le personnage peut disparaître et réapparaître 5 mètres plus loin avant de toucher la cible de Malice. Si le personnage ne touche pas de créature après être réapparu, il subit les dégâts de Malice. Malice inflige 1 dégât supplémentaire.
Martyr	Trois fois par jour, le personnage peut s'infliger la souffrance d'un allié. Il peut s'infliger au moins 1 PV de dégâts pour redonner 3 PV à un allié sur lequel il pose la main. Cette guérison est augmentée de 7  si le personnage se rend inconscient  dans le processus. (Le personnage doit obligatoire perdre au moins 1 de ses vrais PV. S'il a des PV temporaires ou des points d'armure il doit les sacrifier et tout de même s'infliger au moins 1 dégâts dans ses PV par la suite.)
Médecine	En prodiguant des soins à une cible inconsciente durant 30 secondes, le personnage peut guérir la cible de 1 pv.
Menace	Le personnage peut infliger des dégâts Critiques avec Provocation.
Mentor	Le personnage gagne deux usage d'Entraînement. De plus, le personnage peut se faire le mentor de deux alliés au lieu d'un. Au bout de 5 minutes de pratique, les deux alliés et le personnage gagnent 2 PE temporaires. Le personnage doit participer à l'entraînement et superviser les deux alliés. Cet effet ne se cumule pas avec lui-même.
Métabolisme	Les effets de Paralysie. d'Immobilisation et de Lenteur sont divisés en deux, avec un minimum de 5 secondes.
Métamagie	Le personnage peut dépernser des PE pour modifier la nature de ses sorts. Le personnage ne peut pas combiner ces effets entre eux.  1 PE: Le personnage peut changer l'élément de ses deux prochains sorts pour qu'ils infligent des dégâts de Feu, de Froid, de Foudre ou Magiques au lieu des dégâts réguliers du sort.  1 PE: Le personnage peut pour changer la portée d'une Invocation de Toucher en Catalyseur. 1 PE: Le personnage peut pour retarder l'activation d'un sort et garder le sortilège en main pendant une minute au lieu des 10 secondes habituelles. 2 PE: Le personnage peut réduire l'incantation d'une invocation à seulement les deux derniers mots. 2 PE: Le personnage peut doubler la durée de l'effet d'une invocation. 2 PE: Le personnage peut incanter une invocation sans faire le moindre bruit ou geste. Le personnage doit tout de même prendre le temps d'énoncer l'incantation du sort silencieusement.
Meurtrier	Le personnage peut infliger des dégâts Critiques ou Magiques avec son Égorgement, et si la cible d'Égorgement tombe inconsciente, le personnage peut décider de l'achever instantannément.
Mille combats	Affront dure désormais jusqu'à la fin du combat.
Mine	Le personnage peut désormais poser ses bombes comme des pièges. Le personnage doit attendre 10 secondes entre chaque mine qu'il souhaite déclencher. (Le personnage pose le catalyseur au sol et le piège est déclenché quand un créature pose le pied dans un rayon de 1 mètre autour du catalyseur. Le personnage doit être présent pour dire les effets du piège.)
Minion	Une fois par événement, le personnage peut conjurer un minion de son Patron qui prend possession du corps d'un defunt pour 2 minutes. Les charactéristiques du minion sont déterminées par le Pacte choisi par le personnage. La durée de l'effet est augmentée à 30 minutes s'il cible le corps d'un joueur.
Moisson	Le personnage peut canaliser les esprits trépassés pour récupérer son énergie mentale. En achevant une créature, le personnage récupère 2 point de Magie.
Moisson	Le personnage peut canaliser les esprits trépassés pour récupérer son énergie mentale. En achevant une créature, le personnage récupère 2 point de Magie.
Motivation	1 PE: en mettant la main sur un allié et en le motivant (Lui donner un ordre, promettre la victoire, scander sa gloire) le personnage peut lui conférer 3 points de vie temporaires pour la durée du combat.
Muraille	Le personnage peut affecter deux alliés au toucher en plus de lui-même avec Bastion au coût de 1 PE supplémentaire.
Obstination	1 PE: le personnage peut ignorer les dégâts d'une attaque physique. Ne fonctionne pas contre une Attaque surprise. Le personnage subit quand même les effets de la frappe qu'il encaisse.
Obstination	1 PE: le personnage peut ignorer les dégâts d'une attaque physique. Ne fonctionne pas contre une Attaque surprise. Le personnage subit quand même les effets de la frappe qu'il encaisse.
Obus arcane	Le personnage peut lancer un catalyseur qui inflige 1 dégât magique.
Occultisme	Le personnage récupère 2 points de Vie chaque fois qu'il inflige des dégâts Critiques.
Onction	Une fois par jour, le personnage peut effectuer une courte messe de quelques minutes pour dissiper tous les effets magiques qui affligent un allié
Opportunisme	Utiliser Disparition redonne un usage d'Initiative au personnage.
Orage	Lorsque le Shaman touche une cible avec Éclair, il peut infliger 1 dégât de Foudre à une cible différente à moins de 5 mètres de la créature touchée par Éclair.
Ordre de combat	1 PE: le personnage peut motiver un allié pour lui donner un usage gratuit de Coup puissant. Ceci est un effet  (Doit être utilisé dans les 10 secondes suivant l'utilisation de la compétence)
Ordre de victoire	1 PE: Le personnage peut accorder un usage temporaire d'une compétence de Coup puissant à 1 PE qu'il connait à un allié. (Doit être utilisé dans les 10 secondes suivant l'utilisation de la compétence)
Ouverture	La première attaque pendant Duel inflige +2 dégâts. 
Pacte	Le personnage forme un pacte avec une entité d'outremonde. Le personnage doit choisir un type de pacte et un Patron qu'il souhaite servir par son pacte. Le personnage doit avoir un objet qui représente son lien avec son Patron pour utiliser les compétences liées à son pacte. Le personnage peut utiliser la compétence de 'Pacte' de son Patron.
Paix	La cible de Rappel à la vie récupère 3 points de vie après une minute de repos.  La cible ne peut pas se battre, utiliser de compétences ou courir pour être considéré 'au repos'.
Palais de l'esprit	Une fois par jour, en se servant des résultats de son autopsie et des preuves laissées sur la scène, le personnage peut recréer les circonstance de la mort d'une créature dans son esprit. La créature pourra raconter au personnage les 5 minutes précédant et suivant sa mort, en évitant cependant de nommer les autres personnes présentes à cet instant. Le personnage pourra donc savoir exactement comment la créature est morte, si elle a été fouillée par la suite, etc.
Pansement	Avec 15 minutes de travail, le personnage peut fabriquer une trousse de soins qui redonnera 3 points de vie à une cible en l’appliquant pendant 10 secondes.  De plus, le personnage peut dépenser 1 PE lors de l'application d'une trousse pour soigner la cible de 3 PV supplémentaires. (Cette action ne s'effectue qu'une fois par trousse appliquée.) Le personnage peut avoir un maximum deux trousses avec lui.
parchemin	Le personnage peut utiliser un sortilège qu'il connait et l'inscrire sur un parchemin afin qu'il puisse être utilisé plus tard. (Le personnage dépense des points de Magie pour inscrire un parchemin.)
Partenaire	1 PE: Le personnage entre dans une posture de combat protectrice et désigne un allié comme son Partenaire.  Pendant sa posture, le personnage et son Partenaire gagnent 2 PV temporaires. Le personnage ne peut pas avoir de Partenaire s'il est déjà le Partenaire de quelqu'un d'autre.
Passion	Le personnage peut affecter une personne de plus avec Hymne.
Pénitence	Le personnage lance un catalyseur qui inflige 2 dégâts. Le type de dégâts est déterminé par l'allégeance du personnage.
Perception	Le personnage peut voir sa Proie même si elle disparaît ou devient invisible.
Persécution	2 PE: Le personnage peut concentrer son regard sur une créature. En posant la main sur celle-ci, il peut savoir si la créature possède des compétences en lien avec la sorte de magie qu'il détecte avec Regard.
Peur	1 PE: Le personnage canalise les âmes errantes et damnées pour affliger sa cible de terreur. Le personnage  effectue une frappe qui inflige un effet de Peur (1 minute) à la cible. Ceci est une compétence de combat.
Piège	1 PE: Le personnage pose un piège au sol, représenté par un catalyseur ou un accessoire approprié. Le piège inflige 3 dégâts physiques à une créature. Le personnage déclenche le piège lui-même. Le personnage peut poser un seul Piège à la fois.
Piège de lames	Chausse-trappe inflige 3 dégâts Critiques.
Pièges magiques	Piège inflige des dégâts de Feu, de Froid, de Foudre ou Physiques, au choix du personnage. Le personnage peut déployer un Piège de plus.
Pistage	Le personnage est immunisé aux effets de Lenteur, et les effets d'Immobilisation infligés par sa Proie deviennent des effets de Lenteur.
Poigne du sous-monde	1 PE: le personnage peut conjurer les forces occultes et amener une créature à lui. Le personnage pointe une créature et lui inflige un effet de Projection (5 mètres) vers lui.
Pointe magique	Le personnage peut infliger des dégâts Magiques, Bénis ou Maudits avec les projectiles qu'il fabrique.
Pointe primordiale	Le personnage peut infliger des dégâts de Feu, de Froid ou de Foudre avec les projectiles qu'il fabrique.
Points faibles	Le personnage peut examiner le corps d'une proie pour apprendre une de ses faiblesses, si elle en a une.
Polyvalence	Le personnage acquérit une compétence Tier 1 d'un autre arbre de compétence. Le personnage ne peut pas choisir un compétence d'un arbre qu'il possède déjà et ne peut pas choisir une compétence de magie.
Porte de fer	1 PE: Le personnage entre dans une posture de combat défensive. Durant sa posture, le personnage réduit les dégâts de ses armes de 1, mais réduit également les dégâts qu'il subit de 1. Ceci est une posture de combat.
Possession	Une fois par jour, le personnage passe de l'autre côté du Voile de la Mort et prends possession de l'esprit d'une cible pendant 15 minutes. Le personnage suis la cible hors-jeu et peut lui donner des ordres qu'elle devra effectuer. Le personnage peut parler à la place de la cible et la diriger, etc.  Le personnage est expulsé du corps de la cible à la fin de la durée de Possession ou s'il en est expulsé par un effet. Le personage ne peut pas posséder une cible sous l'effet du sort "Protection contre la possession" ou tout autre effet similaire. Le personnage ne peut pas utiliser ses compétences ou les compétences de la cible pendant la possession.
Poudre noire	Le temps de bidouillage pour Bombe est réduit à 5 minutes.
Pourparler	Une fois par jour, le personnage peut déclarer un arrêt de combat entre lui un exterieur en criant "Pourparler". L'exterieur affecté ne peut plus attaquer le personnage tant que le personnage ne l'attaque pas ou ne participe pas au combat contre lui.
Préparation	1 PE: Le personnage vérifie les défences et l'équipement d'un allié pour lui conférer 3 PV temporaires. De plus, le personnage apprends une langue morte de son choix.
Prévoyance	Le personnage gagne 4 points de vie temporaire lorsqu'il utilise Provocation. Ces points de Vie temporaires se dissipent à la fin du combat.Le personnage gagne 4 PV temporaires lorsqu'il utilise Provocation. Cet effet peut uniquement se produire une fois par ennemi. Les PV temporaires se dissipent à la fin du combat.
Prières int.	Le personnage apprends trois prières intermédiaires et une prière mineure. Le personnage possède 10 points de Magie.
Prières int.	Le personnage apprends trois Prières intermédiaires et une Prière mineure. Le personnage possède 10 points de Magie.
Prières maj.	Le personnage apprends trois Prières majeures, une Prière intermédiaire et une Prière mineure. Le personnage possède 15 points de Magie. Le personnage peut seulement acquérir cette compétence s'il ne possède pas d'autre compétence de Sorts majeurs.
Prières min.	Le personnage apprends 3 prières mineures. Le personnage possède 5 points de Magie.
Prières min.	Le personnage apprends trois Prières mineures. Le personnage possède 5 points de Magie.
Proie	1 PE: Le personnage entre dans une posture de combat et désigne une créature non-humanoïde comme sa proie pour la durée du combat. Le personnage récupère 2 PE s'il porte le coup fatal à sa Proie. Ceci est une posture de combat.
Projection	1 PE: Le personnage frappe la cible et lui inflige un effet de Projection (5 mètres). Ceci est une compétence de combat.
Projection	1 PE: Le personnage frappe la cible et lui inflige un effet de Projection (5 mètres). Ceci est une compétence de combat.
Promesse de victoire	Motivation donne 5 points de Vie temporaires.
Providence	Encaisser un sort avec Évangélisme accorde un usage gratuit de Coup puissant, qui doit être utilisé immédiatement contre la source du sort.
Provocation	1 PE: Le personnage frappe sa cible et la provoque à l'attaquer en plus de lui infliger les dégâts de son arme. Ceci est une compétence de combat.
Prudence	1 PE: Le personnage entre dans une posture prudente qui l'empêche de déclencher les pièges. Durant sa posture, le personnage ne peut pas courir mais ne déclenche pas de pièges en marchant ou en manipulant des objets. Ceci est une posture de combat.
Purge	2 PE: le personnage peut mettre fin à un effet de magie qui l'affecte.
Purification	Une fois par événement, le personnage peut tenter de purifier une malédiction majeure ou ancienne qui afflige un objet, un lieu ou une personne. Cette compétence n'est pas garantie de fonctionner.
Rage	1 PE: Le personnage pousse un hurlement et entre dans un rage profonde et puissante pendant 2 minutes.  Durant la durée de Rage, le personnage inflige +1 dégâts avec ses armes. Le personnage tombe inconscient quand la rage prends fin. Rage prends fin si le personnage passe 10 secondes sans attaquer une créature. (Allié ou ennemi.) Ceci est une posture de combat.
Rappel à la vie	1 PE: Le personnage peut soigner une créature inconsciente. La cible récupère 1 point de Vie. 
Réanimation	1 PE: Le personnage peut appliquer une trousse de soin instantannément.
Recherche et développement	Une fois par jour, le personnage peut passer 30 minutes et 3 points de Magie pour tenter d'inventer une nouvelle Invocation sur un parchemin. Le personnage doit déterminer la portée, la cible, la durée et l'effet du sort, qui doit ensuite être approuvé par un Maître de jeu. Il est possible que les résutats soient inattendus. Le parchemin est à usage unique, ne peut pas être copié, et doit être utilisé par le personnage qui l'a créé.
Réclusion	Vivre en harmonie et en paix dans la nature revigore le personnage. Une fois par jour, s'il s'isole pendant au moins 15 minutes dans la nature, immobile et hors-combat, il regagne tous ses PV. 
Reflet 	Toucher une cible avec Obus Arcane redonne 1 PE au personnage.
Réflexes	Le personnage est immunisé aux effets Renverse et les effets de Projection deviennent des effets de Renverse.
Régal de la douleur	Le personnage peut s'infliger 5 dégâts et récupérer tous ses PE. Cette compétence ne peut pas être utilisée plus d'une fois par 15 minutes. (Le personnage doit obligatoire perdre au moins 3 de ses vrais PV. S'il a des PV temporaires ou des points d'armure il doit les sacrifier et tout de même s'infliger au moins 3 dégâts dans ses PV par la suite.)
Regard	Le personnage peut détecter la magie du regard. À l'acquisition de la compétence, le personnage choisit une sorte de magie parmi Arcane, Bardique, Chamanique, Magie Noire ou Nécromancie. Il peut détecter l'influence de la sorte de magie choisie en observant un objet ou en posant la main sur une créature affectée par cette sorte de magie. Le personnage ne peut pas savoir si la créature touchée est capable de faire ladite sorte de magie, seulement si elle en est sous l'effet. La branche d'Inquisition est incompatible avec les branches associées aux sortes de magies qu'il détecte.
Remède	Le personnage gagne un usage quotidien de Cure. Le personnage peut désormais dissiper un effet magique néfaste avec Cure. Cure ne peut pas retirer les bénédictions ou les malédictions, cependant.
Rempart	1 PE: Le personnage peut ignorer une perte ou un bris de bouclier.
Renverse	1 PE: Le personnage frappe les jambes de sa cible et lui inflige un effet de Renverse. Renverse n'inflige pas de dégâts.
Repentance	Une fois par jour, le personnage peut engourdir son corps aux assauts qu'il subit. Se flageller pendant 2 minutes permet au personnage de dissiper les effets de poison, de maladie, ou de magie de niveau intermédiaire ou inférieur qui l'affligent. Le personnage doit sacrifier 5 de ses points de Vie en se flagellant.
Représailles	Le personnage récupère 1 PE lorsqu'il subit une attaque physique qui lui inflige 4 dégâts ou plus.
Rescousse	Le personnage peut transporter une créature inconsciente sans être ralenti, ou transporter deux créatures inconscientes en même temps en étant ralenti.
Réserve	Une fois par événement, le personnage peut récupérer instantannément tous ses projectiles fabriqués. De plus, le personnage peut fabriquer et emmagasiner 5 projectiles en 5 minutes avec Carquois.
Résistance	Tant qu'il a son bouclier au bras et qu'il mime de bloquer les sorts, le personnage réduit de 1 les dégâts des sorts qui le ciblent lui uniquement (Toucher, Catalyseur ou portée Directe).
Résolution	Le personnage est immunisé aux effets de Peur.
Restauration	Rappel à la vie redonne 3 points de Vie supplémentaires.
Retour d'effet	Le personnage peut renvoyer les effets d'une frappe avec Retour de coup.
Retour de coup	Une fois par jour, le personnage peut effectuer une frappe qui inflige des dégâts égaux à une attaque qu'il reçoit. Le personnage doit utiliser cette frappe immédiatement contre la source qui l'a frappé. (Si les dégâts reçus sont supérieur à 5, le personnage inflige 5 avec Retour de coup.)
Rétribution	Utiliser Retour de coup ou Régal de la douleur augmente les dégâts de la prochaine frappe physique de 1. Cet effet ne se cumule pas avec lui-même.
Revanche	Utiliser Duel contre une cible qui a déjà été ciblée par Duel dans le même combat double les points de Vies temporaires de Duel.
Réveil	2 PE: Le personnage peut dissiper un effet de Charme, de Peur ou de Lenteur sur un allié, tant que lui-même n'est pas sous l'influence d'un de ces effets.
Riposte	Immédiatement après avoir désarmé une cible, la prochaine attaque du personnage inflige +1 dégâts.
Rites int.	Le personnage apprends trois Rites intermédiaires. Le personnage possède 10 points de Magie.
Rites int.	Le personnage apprends trois Rites intermédiaires. Le personnage possède 10 points de Magie.
Rites majeurs	Le personnage apprends trois Rites majeurs. Le personnage possède 15 points de Magie. Le personnage peut seulement acquérir cette compétence s'il ne possède pas d'autre compétence de Sorts majeurs.
Rites mineurs	Le personnage apprends trois Rites mineurs. Le personnage possède 5 points de Magie.
Rites mineurs	Le personnage apprends trois Rites mineurs. Le personnage possède 5 points de Magie.
Robustesse	Le personnage gagne 2 points de Vie temporaire lorsqu'il utilise Coup puissant durant Affront. Les points de Vie durent jusqu'à la fin d'Affront.
Sabbat	Le personnage peut conduire les Sabbats reliés à sa pratique.
Sang épais	1 PE: le personnage peut ignorer une attaque ou un sort qui inflige des dégâts Critiques.
Saturation	1 PE: Le personnage canalise l'Arcane au travers de son corps et entre dans une posture de combat. Pendant la durée de Saturation, chaque fois que le personnage subit un sort de dégâts, il récupère ou 1 PE. Saturation prends fin si le personnage récupère tous ses PE. Ceci est une Posture de combat.
Scarifications	Le personnage est couvert de scarifications rituelles qui font témoignage de son endurance et sa constitution. Les points de Vie temporaires accordés par Cicatrices passent à 6. Cependant, le personnage possède de manière permanente un blessure mineure qui ne peut en aucun cas être guérie.
Scintillement	Obus arcane inflige 1 dégât supplémentaire. 
Second souffle	2 PE: Le personnage puise dans sa force vitale et récupère 4 points de Vie. Le personnage doit avoir moins de la moitié de ses PV pour utiliser cette compétence.
Second souffle	2 PE: Le personnage puise dans sa force vitale et récupère 4 points de Vie. Le personnage doit avoir moins de la moitié de ses PV pour utiliser cette compétence.
Secours	Le personnage peut amener une créature avec lui en utilisant Disparition.
Sentinelle	Le Partenaire du personnage réduit les dégâts physiques qu'il subit de 1.
Soins	Fabriquer des trousses de soins demande désormais 10 minutes au lieu de 15. De plus, le personnage peut dépenser 3 PE lors de l'application d'une trousse pour soigner la cible de 9 PV supplémentaires.
Spiritisme	Le personnge peut voir les esprits et peut communiquer avec eux. Les esprits ne sont pas forcément amicaux ou coopératifs, cependant.
Stabilité	1 PE: Le personnage entre dans une posture de combat stable qui l'empêche de perdre pied. Pendant la durée de sa posture, le personnage est immunisé aux effets de Renverse et de Projection. Ceci est une posture de combat.
Stabilité	1 PE: Le personnage entre dans une posture de combat stable qui l'empêche de perdre pied. Pendant la durée de sa posture, le personnage est immunisé aux effets de Renverse et de Projection. Ceci est une posture de combat.
Stase	2 PE: Le personnage canalise l'arcane dans une frappe paralysante. Le personnage peut utiliser son Coup puissant pour infliger un effet de Paralysie (10 secondes). La frappe n'inflige aucun dégâts. Ceci est une compétence de combat. 
Supériorité	Les Coup puissants du personnage et de ses alliées effectués avec les PE temporaires conférés par Entraînement infligent +1 dégâts. (Pour un total de +2)
Surpuissance	Si un Coup puissant ou une compétence de Coup puissant du personnage est ignorée ou résistée, le personnage récupère les PE dépensés.
Survie	Une fois par jour, le personnage peut récupérer 1 PV à tout moment lors de sa période d'inconscience. Le personnage peut utiliser cette compétence pour éviter de se faire achever.
Tactiques	Utiliser Coup puissant permet au Partenaire d'utiliser Coup puissant immédiatement et gratuitement contre la même cible.
Talent	1 PE: Le personnage peux toucher une cible et lui infliger un effet de Charme (10 secondes).  De plus, le personnage sait parler le Bardique.
Témérité	Les effets de Hymne durent pendant 1 minute après que le personnage cesse de chanter.
Tempête	Orage affecte une cible différente de plus et inflige 1 dégât supplémentaire.
Thésaurus	Deux fois par jour, le personnage peut fouiller dans ses livres afin d'identifier un objet ainsi que ses effets si l'objet en possède. Certains objets sont particulièrement difficiles et inscrutables et demandent des connaissances plus approfondies afin de les identifier. Le personnage doit faire affaire avec l'Équipe Scénaristique afin de savoir ce qu'il découvre.
Tir de précision	Le personnage peut utiliser des compétences de Coup puissant avec des armes de lancer et à distance.
Tir explosif	Le personnage peut dépenser 3 de ses projectiles fabriqués pour infliger 3 dégâts de Feu dans un rayon de 3 mètres autour de son projectile.
Tir fantôme	1 PE: En dépensant un de ses projectiles fabriqués, le personnage peut lancer un tir fantômatique qui touche assurément la cible. Tir fantôme inflige 3 dégâts Physiques à une cible à portée directe. Tir fantôme peut bénéficier de Pointe primordiale ou de Pointe magique. (Le personnage doit mimer d'utiliser son arme à distance en utilisant Tir fantôme.)
Tir rapide	Utiliser Disparition donne instantannément un projectile fabriqué au personnage.
Torture	Au bout de 10 minutes de questionnement accompagné de techniques de persuasion, le personnage peut poser une question à sa cible. Celle-ci doit répondre au mieux de ses connaissances.
Totem	Le personnage gagne 2 points de vie temporaires tant qu'il porte de l'armure légère ou aucune armure. Ces points de vie temporaires se régénèrent après 10 minutes passées hors combat.  Le personnage ne bénéficie pas du bonus de Totem s'il porte de l'armure lourde. Le totem doit être préalablement approuvé par l'Équipe Scénaristique.
Trahison	(Cette compétence de coûte pas d'expérience à acquérir.) Le personnage accède à une version sacrilège de la Conjuration. Trahir ses pactes peut cependant avoir de graves conséquences...
Tranquilité	Berceuse peut affecter toutes les cibles dans un rayon de 1 mètre autour du personnage pour 2 PE au lieu de 1. Les cibles affectées par Berceuse récupèrent un point de vie à chaque minute pendant la durée. L'effet affecte uniquement les cibles présentes dans la zone à l'activation de la compétence.
Traque	Le personnage est immunisé aux effets de Charme, de Suggestion et de Peur infligés par sa proie.
Versatilité	Le personnage acquérit une compétence 'À l'achat' ("Tier 0") d'un autre arbre de compétence. Le personnage ne peut pas choisir un compétence d'un arbre qu'il possède déjà et ne peut pas choisir une compétence de magie.
Vertue	Une fois par jour, le personnage peut toucher une créature et la guérir d'un montant de PV égal aux PV maximum du personnage.
Vétéran	Si un adversaire frappe la cible de Garde du corps, le personnage augmente ses dommages de 1 contre cet adversaire pour la durée du combat. Ce bonus ne se cumule pas plus d'une fois par adversaire.
Victorieux	Le personnage récupère son usage quotidien de Duel s'il en sort victorieux.
Vie d'agonie	Tant que le personnage a au moins deux blessures, les Coups puissants et les compétences de Coup puissant du personnage infligent +1 dégâts. (Les compétences de Coup puissant du personnage qui n'infligent pas de dégâts restent identiques.)
Vie de souffrance	Subir une deuxième blessure durant un événement retire le besoin de se mutiler pour Régal de la douleur.
Vigueur divine	Toucher une cible avec Pénitence redonne 1 PE au personnage.
Violence	Pendant la durée de Rage, le personnage inflige 1 dégâts supplémentaire avec Coup puissant.
Vivacité	Le personnage peut désormais utiliser son Esquive pour éviter un sort qui le cible lui uniquement (Toucher, catalyseur ou portée directe).